[
	[1,1,1,1,1,1,1,1,1,1,1,1,1,1,1,1,1,1],
	[1,6,2,2,0,2,3,3,0,2,6,2,6,1,5,2,6,1],
	[1,1,0,0,1,6,4,5,0,0,1,5,4,0,0,0,3,1],
	[1,0,6,0,4,7,3,3,0,0,4,2,0,2,2,0,3,1],
	[1,1,0,0,1,4,0,5,2,5,3,5,4,0,0,0,3,1],
	[1,6,5,5,2,3,2,5,0,0,4,3,0,6,0,0,4,1],
	[1,1,0,0,3,3,2,5,6,0,4,3,4,0,0,0,1,1],
	[1,6,2,5,3,3,2,0,0,0,4,3,2,0,0,2,6,1],
	[1,4,0,0,0,0,3,0,5,0,0,0,0,0,0,0,3,1],
	[1,4,0,0,0,0,0,4,0,0,0,3,0,0,0,0,1,1],
	[1,6,5,0,0,2,2,0,0,0,3,0,5,0,5,5,6,1],
	[1,1,1,1,1,1,1,1,1,1,1,1,1,1,1,1,1,1]
]
