[
	[1,1,1,1,1,1,1,1,1,1,1,1,1,1,1,1,1,1],
	[1,6,4,0,0,0,0,3,0,0,0,0,5,0,0,0,1,1],
	[1,4,0,0,0,0,3,0,0,4,0,0,0,3,0,0,0,1],
	[1,0,2,1,0,1,6,1,0,0,2,0,2,2,0,2,0,1],
	[1,2,0,0,2,2,1,0,1,0,4,0,0,0,0,0,0,1],
	[1,2,0,2,0,4,0,3,3,0,0,5,0,5,5,0,0,1],
	[1,0,0,0,0,0,4,0,3,4,0,3,0,0,0,0,3,1],
	[1,0,0,0,5,1,0,0,0,1,0,0,0,3,5,5,0,1],
	[1,6,0,0,2,0,0,0,1,0,0,0,5,3,0,1,0,1],
	[1,6,4,0,0,0,3,3,2,4,4,0,0,0,0,0,3,1],
	[1,7,0,5,5,0,5,5,5,6,1,4,0,0,0,1,6,1],
	[1,1,1,1,1,1,1,1,1,1,1,1,1,1,1,1,1,1]
]
