[
	[1,1,1,1,1,1,1,1,1,1,1,1,1,1,1,1,1,1],
	[1,6,2,0,1,6,2,6,2,2,6,2,6,1,0,2,6,1],
	[1,1,0,0,0,4,0,0,0,0,0,0,3,0,0,0,1,1],
	[1,6,0,4,0,4,0,0,0,0,0,0,3,0,3,0,6,1],
	[1,1,0,4,0,2,0,5,5,5,5,0,2,0,3,0,1,1],
	[1,6,5,0,0,4,0,3,6,6,4,0,3,0,0,5,6,1],
	[1,6,2,0,0,4,0,3,7,6,4,0,3,0,0,2,6,1],
	[1,1,0,4,0,5,0,2,2,2,2,0,5,0,3,0,1,1],
	[1,6,0,4,0,4,0,0,0,0,0,0,3,0,3,0,6,1],
	[1,1,0,0,0,4,0,0,0,0,0,0,3,0,0,0,1,1],
	[1,6,5,0,1,6,5,6,5,5,6,5,6,1,0,5,6,1],
	[1,1,1,1,1,1,1,1,1,1,1,1,1,1,1,1,1,1]
]
