[
	[1,1,1,1,1,1,1,1,1,1,1,1,1,1,1,1,1,1],
	[1,0,2,0,0,2,0,0,0,0,0,0,0,0,0,2,0,1],
	[1,6,0,2,0,0,0,4,0,2,0,0,0,4,3,3,0,1],
	[1,6,0,2,0,0,4,0,0,3,0,0,2,6,1,0,0,1],
	[1,6,5,2,0,5,0,5,0,2,0,0,0,1,1,0,2,1],
	[1,4,0,0,3,7,4,0,0,0,3,0,0,0,1,2,0,1],
	[1,4,0,0,0,2,1,0,2,0,0,0,0,1,1,0,3,1],
	[1,2,0,0,2,0,0,2,0,0,3,0,5,6,1,5,0,1],
	[1,0,2,0,5,0,2,0,0,0,3,0,0,4,3,0,5,1],
	[1,0,0,0,0,0,0,0,0,0,0,4,0,0,0,0,3,1],
	[1,0,0,0,0,5,0,0,0,0,0,4,0,2,3,0,0,1],
	[1,1,1,1,1,1,1,1,1,1,1,1,1,1,1,1,1,1]
]
