[
	[1,1,1,1,1,1,1,1,1,1,1,1,1,1,1,1,1,1],
	[1,6,1,2,0,1,6,2,6,6,2,6,1,0,3,1,6,1],
	[1,2,4,0,0,3,2,5,6,6,5,2,4,0,0,3,2,1],
	[1,0,0,0,0,0,0,4,0,0,0,0,0,0,0,3,0,1],
	[1,5,5,0,0,0,5,0,0,0,0,5,0,2,0,0,5,1],
	[1,6,1,0,0,1,6,4,0,0,3,6,1,0,3,1,6,1],
	[1,2,7,4,0,3,2,4,0,3,0,2,0,0,0,0,2,1],
	[1,0,4,0,0,0,0,0,0,0,0,0,0,0,0,3,0,1],
	[1,0,0,0,0,0,0,2,2,0,0,0,0,0,0,0,0,1],
	[1,5,0,1,0,0,5,0,0,3,5,5,0,5,1,0,5,1],
	[1,6,4,0,0,3,6,1,5,0,1,6,4,0,0,3,6,1],
	[1,1,1,1,1,1,1,1,1,1,1,1,1,1,1,1,1,1]
]
