[
	[1,1,1,1,1,1,1,1,1,1,1,1,1,1,1,1,1,1],
	[1,6,1,6,2,6,1,6,2,2,0,0,4,0,0,2,0,1],
	[1,5,2,4,0,3,0,0,0,0,0,0,4,0,0,0,3,1],
	[1,0,2,0,2,0,0,0,5,0,0,1,1,0,0,0,0,1],
	[1,0,4,0,0,0,0,0,0,0,2,6,1,4,0,0,0,1],
	[1,0,0,0,0,4,0,0,3,0,0,2,1,0,0,5,2,1],
	[1,0,0,0,0,0,0,5,7,5,5,6,1,0,4,0,0,1],
	[1,0,0,0,0,3,0,3,2,4,0,3,1,0,0,0,0,1],
	[1,0,0,0,0,0,0,0,0,0,1,0,2,3,2,5,5,1],
	[1,0,0,0,0,0,0,5,0,4,0,0,3,0,3,1,5,1],
	[1,0,0,0,5,0,0,0,5,0,1,1,5,2,6,4,4,1],
	[1,1,1,1,1,1,1,1,1,1,1,1,1,1,1,1,1,1]
]
