[
	[1,1,1,1,1,1,1,1,1,1,1,1,1,1,1,1,1,1],
	[1,0,4,0,3,2,0,2,0,1,6,2,4,5,0,0,0,1],
	[1,0,2,0,0,0,0,0,3,2,1,4,0,3,2,0,3,1],
	[1,0,0,2,0,0,0,5,0,0,0,0,4,0,0,0,3,1],
	[1,1,0,0,4,0,0,3,0,5,0,0,4,0,0,3,0,1],
	[1,6,1,0,1,1,0,4,0,0,3,0,0,0,0,4,1,1],
	[1,4,0,0,0,0,0,0,0,0,0,3,3,1,0,2,6,1],
	[1,0,0,0,0,2,5,1,5,0,2,1,6,4,0,0,1,1],
	[1,0,4,5,0,0,1,6,4,0,0,3,3,1,0,5,6,1],
	[1,4,0,0,3,5,7,1,4,0,0,0,4,4,5,2,1,1],
	[1,0,0,4,0,0,0,0,3,0,0,2,5,2,2,4,4,1],
	[1,1,1,1,1,1,1,1,1,1,1,1,1,1,1,1,1,1]
]
