[
	[1,1,1,1,1,1,1,1,1,1,1,1,1,1,1,1,1,1],
	[1,0,0,2,0,0,0,1,2,0,0,2,1,6,4,2,6,1],
	[1,0,4,0,3,0,0,0,0,0,0,2,2,4,0,0,3,1],
	[1,0,2,4,0,0,4,0,0,0,0,0,4,0,3,0,5,1],
	[1,1,0,0,2,0,5,2,0,0,0,5,2,0,2,5,6,1],
	[1,0,4,0,0,0,2,0,0,0,4,0,0,0,3,3,1,1],
	[1,4,0,3,0,0,0,5,0,0,4,0,0,3,0,0,0,1],
	[1,5,0,0,0,0,0,0,3,0,4,0,0,3,0,0,0,1],
	[1,0,2,0,0,4,0,3,0,0,2,0,0,3,5,5,2,1],
	[1,4,0,3,0,0,5,4,0,3,0,3,4,0,0,0,0,1],
	[1,7,5,0,4,0,0,0,0,4,0,3,0,5,0,0,5,1],
	[1,1,1,1,1,1,1,1,1,1,1,1,1,1,1,1,1,1]
]
