[
	[1,1,1,1,1,1,1,1,1,1,1,1,1,1,1,1,1,1],
	[1,4,0,0,0,0,3,0,0,0,0,0,0,0,2,6,6,1],
	[1,4,0,0,0,0,3,0,0,0,0,0,0,0,0,4,3,1],
	[1,4,0,0,0,0,3,5,1,0,5,0,1,2,5,6,2,1],
	[1,6,2,1,1,1,1,5,1,1,6,1,1,2,2,2,5,1],
	[1,6,2,1,6,3,2,0,1,6,1,6,1,0,0,0,0,1],
	[1,6,2,1,1,1,2,7,1,2,5,2,1,0,2,5,2,1],
	[1,6,2,1,6,5,2,0,1,4,5,0,1,0,2,6,3,1],
	[1,4,0,1,2,5,2,0,6,0,0,0,6,0,5,2,4,1],
	[1,4,0,3,2,0,0,0,6,0,0,5,6,0,4,4,4,1],
	[1,6,5,6,2,0,0,0,4,0,0,0,3,0,5,3,6,1],
	[1,1,1,1,1,1,1,1,1,1,1,1,1,1,1,1,1,1]
]
