[
	[1,1,1,1,1,1,1,1,1,1,1,1,1,1,1,1,1,1],
	[1,7,3,6,4,0,0,0,0,0,0,0,0,0,0,3,6,1],
	[1,0,1,1,0,2,4,0,1,1,1,0,0,1,2,0,1,1],
	[1,0,1,4,4,0,0,2,6,1,6,4,0,0,0,3,6,1],
	[1,0,4,0,0,0,3,0,1,6,2,1,0,1,0,0,2,1],
	[1,0,1,0,1,0,0,5,6,1,0,4,0,0,0,3,0,1],
	[1,0,4,0,0,0,1,0,1,6,5,0,0,1,1,1,0,1],
	[1,0,1,2,0,0,1,0,1,1,0,1,4,0,3,0,0,1],
	[1,0,4,0,1,0,1,0,0,0,0,0,0,5,1,0,0,1],
	[1,0,1,5,0,0,1,1,0,1,0,1,1,1,1,0,5,1],
	[1,0,4,0,3,5,1,6,4,0,0,0,0,0,0,3,6,1],
	[1,1,1,1,1,1,1,1,1,1,1,1,1,1,1,1,1,1]
]
