[
	[1,1,1,1,1,1,1,1,1,1,1,1,1,1,1,1,1,1],
	[1,6,2,5,0,0,0,3,0,0,2,0,0,1,6,1,6,1],
	[1,1,0,4,0,3,0,0,3,0,0,0,4,0,4,0,3,1],
	[1,6,5,0,2,4,0,0,3,0,0,4,0,0,0,2,3,1],
	[1,1,0,0,0,3,0,4,0,3,0,4,0,5,3,0,0,1],
	[1,2,0,0,5,0,5,0,7,2,5,0,5,0,0,5,0,1],
	[1,0,2,0,0,2,0,2,5,0,0,2,0,2,0,0,5,1],
	[1,0,0,4,2,0,3,0,4,0,3,0,4,0,0,0,1,1],
	[1,4,5,0,0,0,3,0,0,4,0,0,3,5,0,2,6,1],
	[1,4,0,3,0,3,0,0,0,4,0,0,4,0,3,0,1,1],
	[1,6,1,6,1,0,0,5,0,0,4,0,0,0,2,5,6,1],
	[1,1,1,1,1,1,1,1,1,1,1,1,1,1,1,1,1,1]
]
