[
	[1,1,1,1,1,1,1,1,1,1,1,1,1,1,1,1,1,1],
	[1,4,0,0,0,0,0,3,6,6,4,0,0,0,0,0,3,1],
	[1,6,4,0,0,0,0,0,3,4,0,0,0,0,0,3,1,1],
	[1,6,1,4,0,0,0,1,3,4,0,0,0,0,3,6,6,1],
	[1,6,0,1,4,0,0,3,1,6,4,0,0,3,1,0,6,1],
	[1,6,0,0,1,4,4,1,6,6,1,3,3,1,0,0,6,1],
	[1,6,0,0,6,4,4,6,6,1,6,3,3,6,0,0,6,1],
	[1,6,0,6,4,0,0,4,1,7,3,0,0,3,6,0,6,1],
	[1,6,6,4,0,0,0,0,3,4,0,0,0,0,3,6,6,1],
	[1,6,4,0,0,0,0,0,3,4,0,0,0,0,0,3,6,1],
	[1,4,0,0,0,0,0,3,6,6,4,0,0,0,0,0,3,1],
	[1,1,1,1,1,1,1,1,1,1,1,1,1,1,1,1,1,1]
]
