[
	[1,1,1,1,1,1,1,1,1,1,1,1,1,1,1,1,1,1],
	[1,4,6,1,6,1,6,1,6,2,6,1,6,1,6,1,6,1],
	[1,4,4,0,3,7,4,0,3,5,4,0,3,0,4,0,3,1],
	[1,2,4,0,0,0,0,0,3,0,4,0,0,0,0,0,3,1],
	[1,5,4,0,0,0,0,0,0,0,0,0,0,0,0,0,3,1],
	[1,2,0,2,0,5,2,0,0,2,2,0,0,2,0,2,0,1],
	[1,0,0,0,0,2,2,4,0,0,0,5,0,0,2,0,0,1],
	[1,0,2,0,0,0,0,4,0,0,3,4,0,0,0,3,3,1],
	[1,0,0,0,0,0,0,2,0,5,0,3,0,0,0,0,0,1],
	[1,0,0,0,0,0,0,0,4,0,0,0,0,0,0,0,3,1],
	[1,5,0,5,0,5,0,5,4,0,0,3,0,5,5,5,0,1],
	[1,1,1,1,1,1,1,1,1,1,1,1,1,1,1,1,1,1]
]
