[
	[1,1,1,1,1,1,1,1,1,1,1,1,1,1,1,1,1,1],
	[1,7,4,1,6,2,6,1,0,0,5,0,0,0,0,0,0,1],
	[1,2,0,0,4,0,3,0,0,0,0,0,0,0,0,0,0,1],
	[1,0,0,0,0,2,0,0,0,2,0,0,0,0,3,2,0,1],
	[1,0,0,0,0,0,0,0,4,0,0,0,0,0,0,0,3,1],
	[1,0,0,0,0,0,3,1,6,5,0,0,0,0,0,5,6,1],
	[1,0,0,0,0,0,0,3,4,4,0,0,0,0,0,3,5,1],
	[1,0,0,0,0,0,3,1,6,2,0,0,0,0,0,2,6,1],
	[1,0,0,0,0,0,0,0,4,0,0,0,0,0,0,0,3,1],
	[1,5,0,0,0,0,0,0,0,5,0,0,0,5,0,5,0,1],
	[1,0,5,5,5,5,0,0,0,0,5,5,0,5,0,0,0,1],
	[1,1,1,1,1,1,1,1,1,1,1,1,1,1,1,1,1,1]
]
