[
	[1,1,1,1,1,1,1,1,1,1,1,1,1,1,1,1,1,1],
	[1,1,1,1,1,1,1,1,1,1,1,1,1,1,1,1,1,1],
	[1,1,1,1,0,1,1,1,1,1,1,1,1,1,1,1,1,1],
	[1,1,1,0,5,0,0,2,5,0,1,1,1,0,0,0,0,1],
	[1,1,1,0,1,1,0,1,1,0,1,1,1,0,1,1,0,1],
	[1,7,6,4,0,1,0,4,4,6,4,0,0,0,0,3,6,1],
	[1,1,1,1,1,1,0,1,1,0,1,1,1,0,1,1,0,1],
	[1,1,1,6,2,0,0,3,4,0,1,1,1,0,0,0,1,1],
	[1,1,1,1,0,1,1,1,1,1,1,1,1,1,1,1,1,1],
	[1,1,1,1,1,1,1,1,1,1,1,1,1,1,1,1,1,1],
	[1,1,1,1,1,1,1,1,1,1,1,1,1,1,1,1,1,1],
	[1,1,1,1,1,1,1,1,1,1,1,1,1,1,1,1,1,1]
]
