[
	[1,1,1,1,1,1,1,1,1,1,1,1,1,1,1,1,1,1],
	[1,0,0,2,6,4,0,3,6,2,6,4,3,0,0,1,6,1],
	[1,2,2,0,1,6,6,6,1,0,4,0,0,0,0,0,3,1],
	[1,0,0,0,1,1,6,1,1,0,0,4,0,3,2,2,0,1],
	[1,4,0,0,1,6,1,6,1,0,1,1,1,1,0,0,3,1],
	[1,4,0,0,1,2,7,2,1,0,6,6,6,1,5,0,2,1],
	[1,6,0,0,1,0,5,0,1,0,6,6,1,0,2,0,2,1],
	[1,6,5,0,1,0,5,0,1,0,6,1,4,0,0,0,0,1],
	[1,6,0,5,6,5,0,5,6,5,1,6,6,4,0,0,0,1],
	[1,6,0,0,4,0,0,0,3,0,1,1,1,1,5,0,0,1],
	[1,4,0,0,0,0,0,0,0,3,0,0,0,0,0,0,0,1],
	[1,1,1,1,1,1,1,1,1,1,1,1,1,1,1,1,1,1]
]
