[
	[1,1,1,1,1,1,1,1,1,1,1,1,1,1,1,1,1,1],
	[1,1,1,1,1,1,1,1,1,1,1,1,1,1,1,1,1,1],
	[1,1,1,1,1,1,1,1,1,1,1,1,1,1,1,1,1,1],
	[1,1,1,1,1,1,1,1,1,1,1,1,1,1,1,1,1,1],
	[1,1,1,1,0,0,0,0,0,0,0,0,0,0,0,7,1,1],
	[1,0,0,0,0,1,1,1,1,1,1,1,1,1,5,2,6,1],
	[1,4,6,3,0,0,0,0,0,0,0,0,0,0,6,0,1,1],
	[1,1,1,1,1,1,1,1,1,1,1,1,1,1,2,5,6,1],
	[1,1,1,1,1,1,1,1,1,1,1,1,1,1,1,1,1,1],
	[1,1,1,1,1,1,1,1,1,1,1,1,1,1,1,1,1,1],
	[1,1,1,1,1,1,1,1,1,1,1,1,1,1,1,1,1,1],
	[1,1,1,1,1,1,1,1,1,1,1,1,1,1,1,1,1,1]
]
