[
	[1,1,1,1,1,1,1,1,1,1,1,1,1,1,1,1,1,1],
	[1,6,2,4,0,0,0,1,6,1,6,1,2,1,6,1,6,1],
	[1,2,0,0,0,0,5,1,4,0,3,6,5,6,4,7,3,1],
	[1,0,0,4,0,0,3,1,2,5,0,2,0,2,0,6,0,1],
	[1,5,0,0,0,5,0,1,0,2,2,0,2,0,0,0,0,1],
	[1,4,0,0,0,0,0,1,0,2,0,0,0,0,0,0,3,1],
	[1,0,0,4,0,0,3,1,0,0,0,0,0,0,0,0,3,1],
	[1,0,0,0,0,0,3,1,0,0,0,0,0,0,3,3,0,1],
	[1,0,0,0,0,0,0,1,0,0,0,0,0,0,0,0,3,1],
	[1,0,5,0,5,5,5,1,0,0,0,5,0,5,0,0,0,1],
	[1,4,0,0,0,3,0,0,5,0,1,6,1,6,1,5,0,1],
	[1,1,1,1,1,1,1,1,1,1,1,1,1,1,1,1,1,1]
]
