[
	[1,1,1,1,1,1,1,1,1,1,1,1,1,1,1,1,1,1],
	[1,6,2,4,0,0,0,2,0,6,2,2,0,0,0,0,0,1],
	[1,1,0,4,0,0,3,0,6,7,6,0,0,4,0,0,3,1],
	[1,6,5,0,2,0,2,6,0,6,0,0,0,0,3,2,0,1],
	[1,1,0,2,0,4,0,0,3,0,0,4,0,0,3,0,0,1],
	[1,0,0,0,0,0,0,4,0,0,3,0,0,0,0,0,0,1],
	[1,4,2,0,5,4,0,0,2,2,0,2,0,0,0,5,2,1],
	[1,4,0,3,2,0,0,0,0,0,0,0,2,2,2,0,0,1],
	[1,0,0,0,0,0,5,5,0,0,0,5,0,0,0,3,5,1],
	[1,6,5,0,0,4,0,3,0,5,0,0,0,0,0,0,3,1],
	[1,4,0,0,5,6,0,6,3,4,0,3,5,0,5,0,0,1],
	[1,1,1,1,1,1,1,1,1,1,1,1,1,1,1,1,1,1]
]
