[
	[1,1,1,1,1,1,1,1,1,1,1,1,1,1,1,1,1,1],
	[1,6,2,0,0,2,0,2,0,1,0,6,2,0,2,5,3,1],
	[1,1,0,4,0,0,3,0,2,1,2,1,0,0,0,4,4,1],
	[1,4,5,0,0,0,0,0,0,1,0,0,0,3,0,3,5,1],
	[1,0,0,0,6,6,0,0,3,1,4,0,0,0,0,4,4,1],
	[1,0,2,3,0,0,0,5,0,1,6,0,0,0,0,0,3,1],
	[1,0,0,0,5,0,4,0,0,3,0,6,0,0,4,0,3,1],
	[1,0,0,0,2,1,6,1,0,0,1,0,0,0,2,4,4,1],
	[1,4,0,3,0,2,1,6,2,1,0,0,0,0,4,0,2,1],
	[1,0,2,4,0,0,0,1,0,3,0,1,0,0,5,0,4,1],
	[1,7,0,0,5,5,1,6,5,0,1,6,5,0,1,5,0,1],
	[1,1,1,1,1,1,1,1,1,1,1,1,1,1,1,1,1,1]
]
