[
	[1,1,1,1,1,1,1,1,1,1,1,1,1,1,1,1,1,1],
	[1,2,0,0,0,0,0,0,4,0,0,0,0,0,0,3,6,1],
	[1,0,4,0,0,0,3,1,0,0,0,0,2,0,0,0,1,1],
	[1,5,0,0,5,0,1,6,4,0,0,0,0,0,0,3,6,1],
	[1,0,0,0,3,2,6,1,0,0,0,0,0,0,3,0,1,1],
	[1,4,0,0,3,0,1,6,4,0,0,0,0,0,0,3,6,1],
	[1,0,5,0,0,5,6,1,0,0,5,5,0,0,0,0,1,1],
	[1,0,0,5,0,0,1,6,2,0,0,5,0,5,0,2,6,1],
	[1,0,0,0,3,2,6,1,0,0,3,4,0,3,0,0,1,1],
	[1,4,0,0,3,0,1,6,5,4,0,0,5,6,7,5,6,1],
	[1,0,5,0,0,5,6,1,6,4,0,0,0,0,3,6,1,1],
	[1,1,1,1,1,1,1,1,1,1,1,1,1,1,1,1,1,1]
]
